NO ./src/Textures/N.png
WE ./src/Textures/W.png
F 0	,1	57,	255
C    0,   30,   0
EA ./src/Textures/E.png
SO ./src/Textures/S.png


111111111111111111111
100000000000000000001
100000000000000000001
100000000000000000001
100000000000000000001
10000000000W000000001
100000000000000000001
111111111101111111111
        11111
