EA 					./src/Textu				res/E.png


				SO ./src/Textures/S.png
WE ./src/Tex				tures/W.png

			NO ./src/					Textures/N.png
				F 					0	,1	57,	255
		C    0,   				30,   0

111111111111111111111
100000000000000000001
100000000000000000001
100000000000000000001
100000000000000000001
10000000000N000000001
100000000000000000001
111111111101111111111
1111111111111111111






